SSSSSSSSSSSSSSSS
SSSSSSSSSSSSSSSS
SSSSSSSSSSSSSSSS
SSSSSSSSSSSSSSSS
SSSSSSSSSSSSSSSS
SSSSSSSSSSSSSSSS
SSSSSSSSSSSSSSSS
SSSSSSSSSSSSSSSS
SSSSSSSSSSSSSSSS
SSSSSGGGGGGSSSSS
GGGGGGGGGGGGGGGG
GGGGGGGGGGGGGGGG
GGGGGGGGGGGGGGGG
GGGGGGGGGGGGGGGG
GGGGGGGGGGGGGGGG
GGGGGGGGGGGGGGGG